N ./assets/penguin.xpm
S ./assets/penguin.xpm
W ./assets/penguin.xpm
E ./assets/penguin.xpm

F 220,100,0
C 225,30,0

11111
10
1001
100001
1000N01
100001
1000001
10000001
111111111