NO ./assets/wolftex/redbrick.xpm
SO ./assets/wolftex/redbrick.xpm
WE ./assets/wolftex/redbrick.xpm
EA ./assets/wolftex/redbrick.xpm

F 220,100,0
C 225,30,0

1111111111
1100100011
1000000001
1000000001
1000000001
1100S00011
1000000001
1000000001
1100100011
1111111111