NO ./assets/penguin.xpm
SO ./assets/penguin.xpm
EA ./assets/penguin.xpm
WE ./assets/penguin.xpm

D ./assets/wolftex/pics_xpm/door_0.xpm
A ./assets/fox/b1.xpm ./assets/fox/b2.xpm ./assets/fox/b3.xpm ./assets/fox/b4.xpm ./assets/fox/b5.xpm ./assets/fox/b6.xpm ./assets/fox/b7.xpm

C 0,255,255
F 255,0,255

        1111111111111111111111111
        1000000000110000000000001
        1D11111D11110000000000001
        1001000000000000000000001
111111111011000001110000000000001
10000000001100000111011111D111111
11110111111111011100000010001
1111D111111111011101010010001
11000000110101011100000010001
100000000000000011000000D0001
10000000000000001101010010001
11000001110101011111011110N0111
11110111 1110101 101111010001
11111111 1111111 111111111111