NO ./assets/red.xpm
SO ./assets/green.xpm
WE ./assets/blue.xpm
EA ./assets/yellow.xpm

F 0,255,255
C 255,0,255

1111111111
1100100011
1000000001
1000000001
1000000001
1100N00011
1000000001
1000000001
1100100011
1111111111