NO ./assets/penguin.xpm
SO ./assets/penguin.xpm
WE ./assets/penguin.xpm
EA ./assets/penguin.xpm

F 220,100,0
c 225,30,0

1111111111
1100100011
1000000001
1000000001
1000000001
1100E00011
1000000001
1000000001
1100100011
1111111111
