NO ./assets/wolftex/pics_xpm/redbrick.xpm
SO ./assets/wolftex/pics_xpm/redbrick.xpm
WE ./assets/wolftex/pics_xpm/redbrick.xpm
EA ./assets/wolftex/pics_xpm/redbrick.xpm

F 220,100,0
C 225,30,0

111111
100001
10EE01
111111
