NO ./assets/wolftex/redbrick.xpm
SO ./assets/wolftex/redbrick.xpm
WE ./assets/wolftex/redbrick.xpm
EA ./assets/wolftex/redbrick.xpm

F 220,100,0
C 225,30,0

111111
100001
10NN01
111111
