NO ./assets/red.xpm
SO ./assets/red.xpm
WE ./assets/red.xpm
EA ./assets/red.xpm

C 255,255,255
F 0,0,0

11111111111111111111111111111111111111111111111111111111111111111111111111111111111111111111111111111
1N000000000000000000000000000000000000000000000000000000000000000000000000000000000000000000000000001
11111111111111111111111111111111111111111111111111111111111111111111111111111111111111111111111111111