N ./assets/penguin.xpm
S ./assets/penguin.xpm
W ./assets/penguin.xpm
E ./assets/penguin.xpm

F 220,100,0
C 225,30,0

111111111
100000001
100000001
100000001
1000N0001
100000001
100000001
100000001
111101111