N ./assets/penguin.xpm
S ./assets/penguin.xpm
W ./assets/penguin.xpm
E ./assets/penguin.xpm

F 220,100,0
C 225,30,0


111 111111

101 100001
1001000001
10000N0001
1000000001
1000001001
100001 101
111111 111
