NO ./assets/penguin.xpm
SO ./assets/penguin.xpm
WE ./assets/penguin.xpm
EA ./assets/penguin.xpm

F 220,100,0
C 225,30,0

111111111
100000001
1111N1111
