NO ./assets/penguin.xpm
SO ./assets/penguin.xpm
WE ./assets/penguin.xpm
EA ./assets/penguin.xpm

F 220,100,0
C 225,30,0

111111110
100000001
100000001
100000001
1000N0001
100000001
100000001
100000001
111111111
