NO ./assets/penguin.xpm
SO ./assets/penguin.xpm
WE ./assets/penguin.xpm
EA ./assets/penguin.xpm

F 220,100,0
C 225,30,0


11111111
1000N0001
111111111
