NO ./assets/penguin.xpm
SO ./assets/penguin.xpm
WE ./assets/penguin.xpm
EA ./assets/penguin.xpm

F 220,100,0
C 225,30,0


111 111111
101 100001
1001001001
1000N  101
111111 111
